./simv | tee program.out 
Info: [VCS_SAVE_RESTORE_INFO] ASLR (Address Space Layout Randomization) is detected on the machine. To enable $save functionality, ASLR will be switched off and simv re-executed.
Please use '-no_save' simv switch to avoid re-execution or '-suppress=ASLR_DETECTED_INFO' to suppress this message.
Chronologic VCS simulator copyright 1991-2023
Contains Synopsys proprietary information.
Compiler version V-2023.12-SP2-1_Full64; Runtime version V-2023.12-SP2-1_Full64;  Apr 20 16:59 2025
Running top_tb on: tinyWide
INPUT 0
 -72   28   -4    0    0   16  -20    0 
 -90   25   12    0    0    0    0    0 
 -90   10  -12    0  -16    0    0    0 
 -30    7    9  -24    0    0    0    0 
 -42  -18    0  -22    0    0    0    0 
 -20    0    0    0    0    0    0    0 
 -20    0    0    0    0    0    0    0 
 -29    0    0    0    0    0    0    0 

STAGE 1 OUT 0
 -72   28   -4    0    0   16  -20    0 
 -90   25   12    0    0    0    0    0 
 -90   10  -12    0  -16    0    0    0 
 -30    7    9  -24    0    0    0    0 
 -42  -18    0  -22    0    0    0    0 
 -20    0    0    0    0    0    0    0 
 -20    0    0    0    0    0    0    0 
 -29    0    0    0    0    0    0    0 

INPUT 1
-222 -104  -28  -60  -40    0   20    0 
-160   60   12   -8   20   23   24   22 
  36  -80   48  -40   16    0    0  -22 
 144  -70   18  -24  -40    0    0  -25 
  84   45  -30  -22    0    0    0    0 
  50   14    0    0  -32    0    0    0 
 -20   52  -31    0    0    0    0    0 
  29    0    0  -39    0    0    0    0 

STAGE 1 OUT 1
-222 -104  -28  -60  -40    0   20    0 
-160   60   12   -8   20   23   24   22 
  36  -80   48  -40   16    0    0  -22 
 144  -70   18  -24  -40    0    0  -25 
  84   45  -30  -22    0    0    0    0 
  50   14    0    0  -32    0    0    0 
 -20   52  -31    0    0    0    0    0 
  29    0    0  -39    0    0    0    0 

INPUT 2
-192   92  -28   24   20    0    0    0 
-190 -125    6   -8    0    0    0    0 
 186 -100 -132  -20    0   23  -28    0 
  42  140    9  -48  -40    0    0   25 
   0   45  105   44   27    0    0    0 
  30  -42   44   52    0    0   45    0 
 -20    0  -62   35   41    0    0    0 
   0  -37   38  -39    0   40    0    0 

STAGE 1 OUT 2
-192   92  -28   24   20    0    0    0 
-190 -125    6   -8    0    0    0    0 
 186 -100 -132  -20    0   23  -28    0 
  42  140    9  -48  -40    0    0   25 
   0   45  105   44   27    0    0    0 
  30  -42   44   52    0    0   45    0 
 -20    0  -62   35   41    0    0    0 
   0  -37   38  -39    0   40    0    0 

INPUT 3
-216  -72  -20  -12  -30  -16  -20  -24 
 185 -140  -42  -40  -30  -23    0  -22 
 -48   65   42    0  -32    0    0  -22 
 -54  -98   -9  -12   20    0    0    0 
  84   90   15  -22  -27    0    0    0 
 -50    0   44   26   32    0    0    0 
  80  -52  -31    0    0    0    0    0 
 -29    0   38    0    0    0    0    0 

STAGE 1 OUT 3
-216  -72  -20  -12  -30  -16  -20  -24 
 185 -140  -42  -40  -30  -23    0  -22 
 -48   65   42    0  -32    0    0  -22 
 -54  -98   -9  -12   20    0    0    0 
  84   90   15  -22  -27    0    0    0 
 -50    0   44   26   32    0    0    0 
  80  -52  -31    0    0    0    0    0 
 -29    0   38    0    0    0    0    0 

INPUT 4
-133   14    0    0    0    0    0    0 
 -28   -8    0    0    0    0    0    0 
  10  -20    0    0    0    0    0    0 
   0    0    0    0    0    0    0    0 
   0    0    0    0    0    0    0    0 
   0    0    0    0    0    0    0    0 
   0    0    0    0    0    0    0    0 
   0    0    0    0    0    0    0    0 

STAGE 1 OUT 4
-133   14    0    0    0    0    0    0 
 -28   -8    0    0    0    0    0    0 
  10  -20    0    0    0    0    0    0 
   0    0    0    0    0    0    0    0 
   0    0    0    0    0    0    0    0 
   0    0    0    0    0    0    0    0 
   0    0    0    0    0    0    0    0 
   0    0    0    0    0    0    0    0 

INPUT 5
  77  -14    0    0    0    0    0    0 
  14   -8    0    0    0    0    0    0 
  10   10    0    0    0    0    0    0 
   0    0    0    0    0    0    0    0 
   0    0    0    0    0    0    0    0 
   0    0    0    0    0    0    0    0 
   0    0    0    0    0    0    0    0 
   0    0    0    0    0    0    0    0 

STAGE 1 OUT 5
  77  -14    0    0    0    0    0    0 
  14   -8    0    0    0    0    0    0 
  10   10    0    0    0    0    0    0 
   0    0    0    0    0    0    0    0 
   0    0    0    0    0    0    0    0 
   0    0    0    0    0    0    0    0 
   0    0    0    0    0    0    0    0 
   0    0    0    0    0    0    0    0 

INPUT 6
-168   -4    4   12   20   16   20    0 
 225 -110  -84  -48  -20    0    0    0 
 156  115   54    0  -16    0    0   22 
-150   77   63   36   20    0    0    0 
   7  -81  -30    0   27    0    0    0 
   0   14  -22  -52  -32    0    0    0 
 -20   52   31    0    0    0    0    0 
  29    0    0    0    0    0    0    0 

INPUT 7
-168    0    0    0    0    0    0    0 
   0    0    0    0    0    0    0    0 
   0    0    0    0    0    0    0    0 
   0    0    0    0    0    0    0    0 
   0    0    0    0    0    0    0    0 
   0    0    0    0    0    0    0    0 
   0    0    0    0    0    0    0    0 
   0    0    0    0    0    0    0    0 

STAGE 1 OUT 6
-168   -4    4   12   20   16   20    0 
 225 -110  -84  -48  -20    0    0    0 
 156  115   54    0  -16    0    0   22 
-150   77   63   36   20    0    0    0 
   7  -81  -30    0   27    0    0    0 
   0   14  -22  -52  -32    0    0    0 
 -20   52   31    0    0    0    0    0 
  29    0    0    0    0    0    0    0 

STAGE 1 OUT 7
-168    0    0    0    0    0    0    0 
   0    0    0    0    0    0    0    0 
   0    0    0    0    0    0    0    0 
   0    0    0    0    0    0    0    0 
   0    0    0    0    0    0    0    0 
   0    0    0    0    0    0    0    0 
   0    0    0    0    0    0    0    0 
   0    0    0    0    0    0    0    0 

INPUT 8
-378   68   44   18    0    0    0    0 
 220   15   18   16   10    0    0    0 
-138    5   12   10   16    0    0    0 
  18   49   27   12    0    0    0    0 
  14   -9    0    0    0    0    0    0 
 -30   14    0    0    0    0    0    0 
  40    0    0    0    0    0    0    0 
 -29    0    0    0    0    0    0    0 

INPUT 9
-378    0    0    0    0    0    0    0 
   0    0    0    0    0    0    0    0 
   0    0    0    0    0    0    0    0 
   0    0    0    0    0    0    0    0 
   0    0    0    0    0    0    0    0 
   0    0    0    0    0    0    0    0 
   0    0    0    0    0    0    0    0 
   0    0    0    0    0    0    0    0 

STAGE 1 OUT 8
-378   68   44   18    0    0    0    0 
 220   15   18   16   10    0    0    0 
-138    5   12   10   16    0    0    0 
  18   49   27   12    0    0    0    0 
  14   -9    0    0    0    0    0    0 
 -30   14    0    0    0    0    0    0 
  40    0    0    0    0    0    0    0 
 -29    0    0    0    0    0    0    0 

INPUT 10
-119   -7    0    0    0    0    0    0 
 -21    8   10    0    0    0    0    0 
  10    0    0    0    0    0    0    0 
   0    0    0    0    0    0    0    0 
   0    0    0    0    0    0    0    0 
   0    0    0    0    0    0    0    0 
   0    0    0    0    0    0    0    0 
   0    0    0    0    0    0    0    0 

INPUT 11
  77    0    0    0    0    0    0    0 
  42    0    0    0    0    0    0    0 
   0    0    0    0    0    0    0    0 
   0    0    0    0    0    0    0    0 
   0    0    0    0    0    0    0    0 
   0    0    0    0    0    0    0    0 
   0    0    0    0    0    0    0    0 
   0    0    0    0    0    0    0    0 

STAGE 1 OUT 9
-378    0    0    0    0    0    0    0 
   0    0    0    0    0    0    0    0 
   0    0    0    0    0    0    0    0 
   0    0    0    0    0    0    0    0 
   0    0    0    0    0    0    0    0 
   0    0    0    0    0    0    0    0 
   0    0    0    0    0    0    0    0 
   0    0    0    0    0    0    0    0 

STAGE 1 OUT 10
-119   -7    0    0    0    0    0    0 
 -21    8   10    0    0    0    0    0 
  10    0    0    0    0    0    0    0 
   0    0    0    0    0    0    0    0 
   0    0    0    0    0    0    0    0 
   0    0    0    0    0    0    0    0 
   0    0    0    0    0    0    0    0 
   0    0    0    0    0    0    0    0 

INPUT 12
-402   12    0    0    0    0    0    0 
   0    0    0    0    0    0    0    0 
   0    0    0    0    0    0    0    0 
   0    0    0    0    0    0    0    0 
   0    0    0    0    0    0    0    0 
   0    0    0    0    0    0    0    0 
   0    0    0    0    0    0    0    0 
   0    0    0    0    0    0    0    0 

INPUT 13
-438    0   -4    0    0    0    0    0 
   0    0   -6    0    0    0    0    0 
   0  -20    0    0    0    0    0    0 
  18    0    0    0    0    0    0    0 
   0    0    0    0    0    0    0    0 
   0    0    0    0    0    0    0    0 
   0    0    0    0    0    0    0    0 
   0    0    0    0    0    0    0    0 

STAGE 1 OUT 11
  77    0    0    0    0    0    0    0 
  42    0    0    0    0    0    0    0 
   0    0    0    0    0    0    0    0 
   0    0    0    0    0    0    0    0 
   0    0    0    0    0    0    0    0 
   0    0    0    0    0    0    0    0 
   0    0    0    0    0    0    0    0 
   0    0    0    0    0    0    0    0 

STAGE 1 OUT 12
-402   12    0    0    0    0    0    0 
   0    0    0    0    0    0    0    0 
   0    0    0    0    0    0    0    0 
   0    0    0    0    0    0    0    0 
   0    0    0    0    0    0    0    0 
   0    0    0    0    0    0    0    0 
   0    0    0    0    0    0    0    0 
   0    0    0    0    0    0    0    0 

INPUT 14
-474    0   -4    0    0    0    0    0 
   0    0   -6    0    0    0    0    0 
   0  -20    0    0    0    0    0    0 
  18    0    0    0    0    0    0    0 
   0    0    0    0    0    0    0    0 
   0    0    0    0    0    0    0    0 
   0    0    0    0    0    0    0    0 
   0    0    0    0    0    0    0    0 

INPUT 15
-510    0   -4    0    0    0    0    0 
   0    0   -6    0    0    0    0    0 
   0  -20    0    0    0    0    0    0 
  18    0    0    0    0    0    0    0 
   0    0    0    0    0    0    0    0 
   0    0    0    0    0    0    0    0 
   0    0    0    0    0    0    0    0 
   0    0    0    0    0    0    0    0 

STAGE 1 OUT 13
-438    0   -4    0    0    0    0    0 
   0    0   -6    0    0    0    0    0 
   0  -20    0    0    0    0    0    0 
  18    0    0    0    0    0    0    0 
   0    0    0    0    0    0    0    0 
   0    0    0    0    0    0    0    0 
   0    0    0    0    0    0    0    0 
   0    0    0    0    0    0    0    0 

STAGE 1 OUT 14
-474    0   -4    0    0    0    0    0 
   0    0   -6    0    0    0    0    0 
   0  -20    0    0    0    0    0    0 
  18    0    0    0    0    0    0    0 
   0    0    0    0    0    0    0    0 
   0    0    0    0    0    0    0    0 
   0    0    0    0    0    0    0    0 
   0    0    0    0    0    0    0    0 

INPUT 16
-140    7  -10  152    0    0    0    0 
   0    0    0    0    0    0    0    0 
   0    0    0    0    0    0    0    0 
   0  104    0    0    0    0    0    0 
  40    0    0    0    0    0    0    0 
   0    0    0    0    0    0    0    0 
   0    0    0    0    0    0    0    0 
   0    0    0    0    0    0    0    0 

INPUT 17
 266    0    0    0    0    0    0    0 
   0    0    0    0    0    0    0    0 
   0    0    0    0    0    0    0    0 
   0    0    0    0    0    0    0    0 
   0    0    0    0    0    0    0    0 
   0    0    0    0    0    0    0    0 
   0    0    0    0    0    0    0    0 
   0    0    0    0    0    0    0    0 

STAGE 1 OUT 15
-510    0   -4    0    0    0    0    0 
   0    0   -6    0    0    0    0    0 
   0  -20    0    0    0    0    0    0 
  18    0    0    0    0    0    0    0 
   0    0    0    0    0    0    0    0 
   0    0    0    0    0    0    0    0 
   0    0    0    0    0    0    0    0 
   0    0    0    0    0    0    0    0 

STAGE 1 OUT 16
-140    7  -10  152    0    0    0    0 
   0    0    0    0    0    0    0    0 
   0    0    0    0    0    0    0    0 
   0  104    0    0    0    0    0    0 
  40    0    0    0    0    0    0    0 
   0    0    0    0    0    0    0    0 
   0    0    0    0    0    0    0    0 
   0    0    0    0    0    0    0    0 

STAGE 1 OUT 17
 266    0    0    0    0    0    0    0 
   0    0    0    0    0    0    0    0 
   0    0    0    0    0    0    0    0 
   0    0    0    0    0    0    0    0 
   0    0    0    0    0    0    0    0 
   0    0    0    0    0    0    0    0 
   0    0    0    0    0    0    0    0 
   0    0    0    0    0    0    0    0 

INPUT 18
-516    8    0    0   30  -32   20  -24 
   0    0    6    0  -10 -207    0 -198 
   0   -5   -6   30   48   69   84   22 
  18    7  -81  -12  -40  -35  -32    0 
 -63    9  -30  -22  -54    0  -41   93 
 -10   42   66   78   96   42  -90  -37 
   0 -234    0  -70 -369  -48   48    0 
  29  -37  -38  117  135 -360  123  -80 

$finish called from file "tb/top_tb.sv", line 127.
$finish at simulation time                63200
           V C S   S i m u l a t i o n   R e p o r t 
Time: 6320000 ps
CPU Time:      0.180 seconds;       Data structure size: 129.5Mb
Sun Apr 20 16:59:45 2025
